{
  "levels": [
    [
      " $$##.####  ",
      " $.......$  ",
      " #....G..$  ",
      " #.$...#.#  ",
      " #.......#  ",
      " #G......#  ",
      " #.#...#.#  ",
      " #.......$  ",
      " #.....G.#  ",
      " $$##.####  "
    ],
    [
      " $$##.####  ",
      " .......    ",
      " .   . .    ",
      " ... . ..   ",
      " G$.  G .. .",
      " .#....  G..",
      " .#  . .##. ",
      " ..#.. .... ",
      "   $ .    ..",
      "   $#.##    "
    ],
    [
      "   $#.##    ",
      "     x      ",
      "     ...G   ",
      "     x      ",
      " .x...      ",
      " G . x      ",
      " .x. ...G   ",
      "     x      ",
      "     .      ",
      " ####.####  "
    ],
    [
      " ####.#$#$  ",
      " #..x.x..#  ",
      " #G.   .G#  ",
      " #.. .x..#  ",
      " $x  .##x#  ",
      " #...x...#  ",
      " ####.$#x#  ",
      "    $.#..#  ",
      "    #.x.G#  ",
      "   ##.####  "
    ],
    [
      "   ##.####  ",
      "   $...#    ",
      "   $...#    ",
      "####xxx#$## ",
      "#...xxx...# ",
      "#G..xxx..G# ",
      "#$##xxx###$ ",
      "   #...$    ",
      "   #.G.#    ",
      "   ##.##    "
    ],
    [
      "   ##.##    ",
      "     .      ",
      "     X..G   ",
      "     .      ",
      "  G..X      ",
      "     .      ",
      "     X..G   ",
      "     .      ",
      "     .      ",
      "   ##.##    "
    ],
    [
      "   ##.##    ",
      "     .      ",
      "     .      ",
      "   ..X..    ",
      "   G . G    ",
      "   x.Xx.    ",
      "   .        ",
      "   .G.      ",
      "     .      ",
      "    #.#$    "
    ],
    [
      "    #.#$    ",
      "    #..#    ",
      "    #..#    ",
      " #$##xx#### ",
      " #...xx...# ",
      " #.G.Xx.G.# ",
      " ####xx#$$# ",
      "    $..#    ",
      "    #G.$    ",
      "   ##.##    "
    ],
    [
      "   ##.##    ",
      "   .....    ",
      "   .....    ",
      "            ",
      "    ...  G$ ",
      "$.  .$.  .$ ",
      "$G  .G.     ",
      "            ",
      "   .....    ",
      "   $$.$$    "
    ],
    [
      "   $$.$$    ",
      "   ....     ",
      "            ",
      "            ",
      "    G  G$   ",
      "   G$       ",
      "            ",
      "            ",
      "   .....    ",
      "    $.$$    "
    ],
    [
      "    $.$$    ",
      "   .....    ",
      "            ",
      " $$.. ...   ",
      " #.G. .G.   ",
      " #.G. ...   ",
      " #.## $$.   ",
      "        .   ",
      "  .......   ",
      "   $$.$$    "
    ],
    [
      "   $$.$$    ",
      "   $...#$## ",
      "   $... ..# ",
      "   $... G.# ",
      " $$$...   ##",
      " $. ... ..$#",
      " $. ... .G$#",
      " #G ... ..$#",
      " ###...#####",
      "   ##.$$    "
    ],
    [
      "   ##.$$    ",
      "   ....     ",
      "            ",
      "            ",
      "  GX. ..    ",
      "  .$. G$    ",
      "            ",
      "            ",
      "  ...G...   ",
      "  $$#.###   "
    ],
    [
      "  $$#.###   ",
      "   #...#    ",
      "#$$#...###$ ",
      "#..##.##..$ ",
      "#....X....$ ",
      "#G.##.##G.$ ",
      "$###...$$$$ ",
      "   $.G.#    ",
      "   $...#    ",
      "   ##.##    "
    ],
    [
      "   ##.##    ",
      "   .....    ",
      "            ",
      "     G.     ",
      "      @     ",
      "            ",
      "     G.     ",
      "      @     ",
      "    G..     ",
      "    #.#     "
    ],
    [
      "    #.$     ",
      "#####.$     ",
      "#..x...x..  ",
      "#.       .  ",
      "#.       .  ",
      "#G. x@ .G.$ ",
      "####G .###$ ",
      "   #. .#    ",
      "   #...#    ",
      "   ##.$$    "
    ],
    [
      "   ##.$$    ",
      " $###.####  ",
      " $.......#  ",
      " $x  .   #  ",
      " #.  .   #  ",
      " $G.x@ .G$  ",
      " ###.  ###  ",
      "   $...#    ",
      "   $..G#    ",
      "  $#$.##$   "
    ],
    [
      "  $#$.##$   ",
      "  ......... ",
      "          . ",
      "  x x x x . ",
      "$x@X@ @X@ . ",
      "#. G   G    ",
      "#.          ",
      "#.          ",
      "#G......    ",
      "    #.#$    "
    ],
    [
      "    #.#$    ",
      " @          ",
      "@x   x x@x@ ",
      "   @x@ gx   ",
      "   x     x@ ",
      "         x  ",
      " x     gx@  ",
      "@xxx   x@   ",
      " @  G..@    ",
      "    $.#     "
    ],
    [
      "    $.#     ",
      "            ",
      "            ",
      "            ",
      "            ",
      "            ",
      "            ",
      "            ",
      "            ",
      "    #.#     "
    ]
  ]
}
