{
  "levels": [
    [
      " $$##.####  ",
      " $.......$  ",
      " #....G..$  ",
      " #.$...#.#  ",
      " #.......#  ",
      " #G......#  ",
      " #.#...#.#  ",
      " #.......$  ",
      " #.....G.#  ",
      " $$##.####  "
    ],
    [
      " $$##.####  ",
      " .......    ",
      " .   . ...  ",
      " ... .   .  ",
      " G$.  G ..  ",
      " .#....  G. ",
      " .#  . .##. ",
      " ..#.. .... ",
      "   $ .    ..",
      "   $#.##    "
    ],
    [
      "   $#.##    ",
      "     x      ",
      "     ...G   ",
      "     x      ",
      " .x...      ",
      " G . x      ",
      " .x. ...G   ",
      "     x      ",
      "     .      ",
      " ####.####  "
    ],
    [
      " ####.####  ",
      " #..x.x..#  ",
      " #G.   .G#  ",
      " #.. .x..#  ",
      " #x  .##x#  ",
      " #...x...#  ",
      " ####.##x#  ",
      "    #.#..#  ",
      "    #.x.G#  ",
      "   ##.####  "
    ],
    [
      "   ##.##    ",
      "   $...#    ",
      "   $...#    ",
      "####xxx#$## ",
      "#...xxx...# ",
      "#G..xxx..G# ",
      "#$##xxx###$ ",
      "   #...$    ",
      "   #.G.#    ",
      "   ##.##    "
    ],
    [
      "   ##.##    ",
      "     .      ",
      "     X..G   ",
      "     .      ",
      "  G..X      ",
      "     .      ",
      "     X..G   ",
      "     .      ",
      "     .      ",
      "   ##.##    "
    ],
    [
      "   ##.##    ",
      "     X      ",
      "     X      ",
      "     X      ",
      "     XG     ",
      "     XG     ",
      "     XG     ",
      "     X      ",
      "     X      ",
      "   ##.##    "
    ],
    [
      "   ##.##    ",
      "    #..#    ",
      "    #..#    ",
      " #$##xx#### ",
      " #...xx...# ",
      " #.G.Xx.G.# ",
      " ####xx#$$# ",
      "    $..#    ",
      "    #..$    ",
      "   ##.##    "
    ],
    [
      "   ##.##    ",
      "   .....    ",
      "   .....    ",
      "            ",
      "    ...  G$ ",
      "$.  .$.  .$ ",
      "$G  .G.     ",
      "            ",
      "   .....    ",
      "   $$.$$    "
    ],
    [
      "   $$.$$    ",
      "   ....     ",
      "            ",
      "            ",
      "    G  G$   ",
      "   G$       ",
      "            ",
      "            ",
      "   .....    ",
      "    $.$$    "
    ],
    [
      "    $.$$    ",
      "   .....    ",
      "            ",
      " $$.. ...   ",
      " #.G. .G.   ",
      " #.G. ...   ",
      " #.## $$.   ",
      "        .   ",
      "  .......   ",
      "   $$.$$    "
    ],
    [
      "   $$.$$    ",
      "   $...#$## ",
      "   $... ..# ",
      "   $... G.# ",
      " $$$...   ##",
      " $. ... ..$#",
      " $. ... .G$#",
      " #G ... ..$#",
      " ###...#####",
      "   ##.$$    "
    ],
    [
      "   ##.$$    ",
      "   .....    ",
      "            ",
      "            ",
      "  .X. ...   ",
      "  G$. G$.   ",
      "            ",
      "            ",
      "  ...G...   ",
      "  $$$.###   "
    ],
    [
      "  $$$.###   ",
      "   #...#    ",
      "####...###$ ",
      "#..##.##..$ ",
      "#....X....$ ",
      "#G.##.##G.$ ",
      "####...$$$$ ",
      "   $.G.#    ",
      "   $...#    ",
      "   ##.##    "
    ],
    [
      "    #.#     ",
      "            ",
      "            ",
      "            ",
      "            ",
      "            ",
      "            ",
      "            ",
      "            ",
      "    #.#     "
    ],
    [
      "    #.#     ",
      "            ",
      "            ",
      "            ",
      "            ",
      "            ",
      "            ",
      "            ",
      "            ",
      "    #.#     "
    ],
    [
      "    #.#     ",
      "            ",
      "            ",
      "            ",
      "            ",
      "            ",
      "            ",
      "            ",
      "            ",
      "    #.#     "
    ],
    [
      "    #.#     ",
      "            ",
      "            ",
      "            ",
      "            ",
      "            ",
      "            ",
      "            ",
      "            ",
      "    #.#     "
    ],
    [
      "    #.#     ",
      "            ",
      "            ",
      "            ",
      "            ",
      "            ",
      "            ",
      "            ",
      "            ",
      "    #.#     "
    ],
    [
      "    #.#     ",
      "            ",
      "            ",
      "            ",
      "            ",
      "            ",
      "            ",
      "            ",
      "            ",
      "    #.#     "
    ]
  ]
}
