{
  "levels": [
    [
      " ####.####  ",
      " #.......#  ",
      " #....G..#  ",
      " #.#...#.#  ",
      " #.......#  ",
      " #G......#  ",
      " #.#...#.#  ",
      " #.......#  ",
      " #.....G.#  ",
      " ####.####  "
    ],
    [
      " ####.####  ",
      " #..x.x..#  ",
      " #G.   .G#  ",
      " #.. .x..#  ",
      " #x  .##x#  ",
      " #...x...#  ",
      " ####.##x#  ",
      "    #.#..#  ",
      "    #.x.G#  ",
      "    #.####  "
    ],
    [
      "    #.##$$  ",
      "    $.. G#  ",
      "    $.. .## ",
      "#####..   # ",
      "$.. ... ..$ ",
      "$.G ... G.$ ",
      "$.. ... ..$ ",
      "####...#### ",
      "   #...#    ",
      "   ##.##    "
    ],
    [
      "    #.#     ",
      "    #.$     ",
      " ####.####  ",
      " $..#.#..$  ",
      " $...X...$  ",
      " $G.#.#G.$  ",
      " ####.####  ",
      "   #...#    ",
      "   $G..#    ",
      "   ##.##    "
    ],
    [
      "   ##.##    ",
      "  ......    ",
      "  ......    ",
      "            ",
      "            ",
      "  G     G$  ",
      "  $         ",
      "            ",
      "   G.....   ",
      "   ##.##$   "
    ],
    [
      "   ##.##    ",
      "     x      ",
      "     ...G   ",
      "     x      ",
      "  G...      ",
      "     x      ",
      "     ...G   ",
      "     x      ",
      "     .      ",
      "   ##.##    "
    ],
    [
      "   ##.##    ",
      "     .      ",
      "     X..G   ",
      "     .      ",
      "  G..X      ",
      "     .      ",
      "     X..G   ",
      "     .      ",
      "     .      ",
      "   ##.##    "
    ],
    [
      "   ##.##    ",
      "   $...#    ",
      "   $...#    ",
      "####xxx#### ",
      "#...xxx...# ",
      "#G..xxx..G# ",
      "####xxx#### ",
      "   #...#    ",
      "   #.G.#    ",
      "   ##.##    "
    ],
    [
      "   ##.#     ",
      "   #..#     ",
      "   #..#     ",
      "####xx####  ",
      "#...xx...#  ",
      "#G..Xx..G#  ",
      "####xx####  ",
      "   #..$     ",
      "   #G.$     ",
      "   ##.#     "
    ],
    [
      "   ##.##    ",
      "   $...#    ",
      "####...###$ ",
      "#..##.##..$ ",
      "#....X....$ ",
      "#G.##.##G.$ ",
      "####...$$$$ ",
      "   #G..#    ",
      "   #...#    ",
      "   ##.##    "
    ]
  ]
}
