{
  "levels": [
    [
      " ####.####  ",
      " #.......#  ",
      " #....G..#  ",
      " #.$X..&.#  ",
      " #..x....#  ",
      " #.Gx....#  ",
      " #.&...$.#  ",
      " #.......#  ",
      " #.....G.#  ",
      " ####.####  "
    ],
    [
      " ####.####  ",
      " #..x.x..$  ",
      " #.G   G.#  ",
      " #.. .x..#  ",
      " #x  .##x#  ",
      " #...x...#  ",
      " ####.##x#  ",
      "    #.#..#  ",
      "    #.x.G#  ",
      "    #.####  "
    ]
  ]
}
